5,5,1,1,1,1,1,1,1,1,1,1,1,1,1,4,1,1,1,1
5,5,1,4,1,1,1,1,1,1,1,1,1,1,4,1,1,4,1,1
5,4,1,4,1,1,1,4,1,1,1,1,1,4,1,1,1,4,4,1
5,3,3,3,8,3,3,3,3,3,3,3,3,3,3,3,3,3,3,1
5,3,3,3,3,3,3,3,3,3,3,8,3,3,3,3,3,3,3,1
4,3,3,1,1,1,5,5,4,3,3,1,1,1,1,4,1,3,3,4
1,3,3,1,4,1,1,5,1,3,3,1,1,4,1,1,4,3,3,1
1,3,3,1,1,4,1,1,1,3,3,1,4,1,1,1,1,3,3,4
1,3,3,1,1,1,1,4,1,3,3,1,4,1,1,4,1,3,3,1
6,3,3,6,6,6,6,6,6,3,3,6,6,6,6,6,6,3,3,6
6,3,3,6,6,6,6,6,6,3,3,6,6,6,6,6,6,3,3,6
4,3,3,1,4,1,1,4,4,3,3,1,4,1,1,4,1,3,3,1
1,3,3,1,1,1,1,1,4,3,3,1,1,1,1,1,1,3,3,1
1,8,3,1,5,5,5,1,1,3,3,1,1,5,5,1,4,3,3,1
1,3,3,4,5,5,5,1,1,3,3,1,5,4,5,4,1,3,3,1
5,3,3,3,3,8,3,3,3,3,3,3,3,3,3,3,3,3,8,1
5,5,3,3,3,3,3,3,3,3,3,3,8,3,3,3,3,3,3,1
5,5,1,1,1,1,5,5,5,1,1,1,1,1,1,5,5,1,1,1
5,5,5,1,1,1,5,5,5,1,4,1,1,1,1,5,5,1,1,4
5,5,5,1,1,1,1,1,1,1,4,4,4,1,1,5,5,1,4,1